%S%%%%%%%%%%%%%%%%%%
%       %        % %
% %%% % %%% % % %% %
% % % % % % % % %  %
% % %%% % %%%% % % %
% % %     %      % %
% % % % % %% % %%% %
%   % % %  % % %   %
% %%% % %%%%%%%%%% %
%   % %          % %
% %%%%%%% % %%%%%% %
%   %     %     %  %
% % % %%% %%% % %  %
% % % % %   % %    %
%%% %%% % % %%%%%% %
%     %   %   %    %
% %%%%% % % %%%%% %%
%   %   % % % % %  %
% % %%%% %%% % %%% %
%%%%%%%%%%%%%%%%%%G%