%S%%%%%%%%%%%%%%%%%%%
%     % %     % %   %
% % % % % %%% % % %%%
% % %       %       %
% % %%% %%%%% %%%%%%%
% % %   %   %       %
%%%%% % % %%% %%%%% %
% %   %     % % %   %
% %%% %%% %%%%% % %%%
%   % % %   %   %   %
%%% %%% %%% %%% % % %
%   %     % %     % %
% %%%%% % %%%%%%% %%%
%     % % % % %   % %
% %%%%% % % % % % % %
% % % % %   %   % % %
% % % %%%%% % %%% % %
%       %       %   %
%%% %%%%%%% % % % %%%
%       %   % % % % %
%%%%%%% % % %%%%% % %
%   % %   % %       %
% % % %%%%%%%%% % % %
% %     % %     % % %
%%%%%%% % % %%%%% % %
%   %         %   % %
%%% %%% %%% %%% % %%%
%       %     % %   %
% % %%%%% %%%%% %%%%%
% %     %     %     %
%%%%%%%%%%%%%%%%%%%G%